𱊜	𪈼
𰾭	鑀
𰾄	鋂
𰶎	譅
𰰨	菕
𰬸	繐
𬺓	齼
𬺈	齮
𬹼	齘
𬸯	鷿
𬸪	鷭
𬸦	鷟
𬸣	鶱
𬸚	鸑
𬸘	鶠
𬷕	鵏
𬶮	鱚
𬶭	鰶
𬶨	鱀
𬶠	鰊
𬶟	鯻
𬶐	鮡
𬶏	鮠
𬶍	鮀
𬶋	鮈
𬴊	驎
𬴃	騞
𬴂	騑
𬳿	駼
𬳽	駪
𬳶	駉
𬳵	駓
𬱟	頠
𬱖	頔
𬯎	隤
𬯀	隮
𬮿	隑
𬮱	闉
𬭼	鐩
𬭸	鏻
𬭶	𨭆
𬭳	𨭎
𬭯	䥕
𬭭	鏚
𬭬	鏏
𬭩	鎓
𬭤	鍭
𬭛	𨨏
𬭚	錞
𬭎	鋐
𬭊	𨧀
𬭁	鉧
𬬿	鉊
𬬻	鑪
𬬹	鉮
𬬸	鉥
𬬱	釿
𬬮	鋹
𬬭	錀
𬬩	釴
𬪩	醲
𬩽	鄩
𬨎	輶
𬨂	軝
𬤝	譓
𬤊	諟
𬤇	諲
𬣳	詪
𬣡	諓
𬣞	詝
𬣙	訏
𬟽	蝀
𬟁	虉
𬞟	蘋
𬜯	䓣
𬜬	蔄
𬙋	纕
𬙊	纆
𬙂	縯
𬘯	綧
𬘭	綝
𬘬	綪
𬘫	綄
𬘩	綎
𬘡	絪
𬘘	紞
𬘓	紃
𬕂	篢
𬒗	𥗽
𬒈	礐
𬍤	璕
𬍡	璗
𬍛	瓅
𬊤	燀
𬊈	燖
𬉼	熰
𬇹	漍
𬇙	浿
𬇕	澫
𬃊	櫍
𬂩	梜
𬀪	晛
𬀩	暐
𫸩	彄
𫷷	廞
𫶇	嵽
𫵷	㠣
𫰛	娙
𫮃	墠
𫭼	𡑍
𫭢	埨
𫭟	塸
𫬐	㘔
𫫇	噁
𫧮	𪋿
𫧃	𣍐
𫢸	僤
𫠜	齯
𫠖	𩿅
𫠒	鱆
𫠑	䱸
𫠐	魽
𫠏	𩵦
𫠌	𩦠
𫠋	騼
𫠊	䮄
𫠈	䫾
𫠇	𩖰
𫠆	頍
𫠅	韚
𫠂	閝
𫠁	鑉
𫠀	䥄
𫟿	鎈
𫟾	𨩰
𫟽	𨧰
𫟼	鐽
𫟻	銂
𫟺	䤤
𫟹	鉷
𫟸	鉽
𫟷	鉝
𫟶	銏
𫟵	鈗
𫟴	鈖
𫟳	釲
𫟲	釚
𫟬	𨟊
𫟫	𨞺
𫟦	䡵
𫟥	䡩
𫟤	䡐
𫟢	䜖
𫟡	誴
𫟠	譂
𫟟	詊
𫟞	訨
𫟕	䕤
𫟑	䖅
𫟇	𦆲
𫟆	緟
𫟅	綡
𫟄	綋
𫟃	絍
𫞷	𥢶
𫞩	璊
𫞨	璼
𫞧	𤩂
𫞦	璾
𫞥	珼
𫞣	㹽
𫞢	𤛱
𫞡	爃
𫞠	爧
𫞝	灍
𫞛	㶆
𫞚	澬
𫞗	潣
𫞅	𦠅
𫝵	嶹
𫝮	孄
𫝭	孆
𫝬	嬇
𫝫	婡
𫝪	𡟫
𫝩	嬦
𫝨	媈
𫝧	㜐
𫝦	㛝
𫝋	𠐊
𫝈	㑮
𫜳	䶲
𫜲	龓
𫜰	齾
𫜯	𪙏
𫜮	齴
𫜭	齭
𫜬	齰
𫜫	𫜦
𫜪	齩
𫜩	齧
𫜨	䶕
𫜟	𪓰
𫜙	䵴
𫜕	𪍠
𫜔	䴽
𫜓	𪌭
𫜒	䴱
𫜑	麷
𫜊	𪉸
𫜅	䴋
𫜄	鷷
𫜃	鷣
𫜂	𪅂
𫜁	鷩
𫜀	鷐
𫛾	𪆷
𫛽	鷅
𫛼	䳫
𫛻	𪃒
𫛺	䳧
𫛹	𪃧
𫛸	鶗
𫛷	鶦
𫛶	鶒
𫛵	鶌
𫛴	鷤
𫛳	鵩
𫛲	鵰
𫛱	鵫
𫛰	䳢
𫛯	鶭
𫛮	䳤
𫛭	鵟
𫛬	䳜
𫛫	鶰
𫛪	鴽
𫛩	鴳
𫛨	鵧
𫛧	𪀖
𫛦	鴮
𫛥	鵊
𫛤	鴐
𫛣	鴥
𫛢	鸋
𫛡	鴔
𫛠	𩿤
𫛟	鸗
𫛞	鴃
𫛝	鴅
𫛜	鴀
𫛛	鳷
𫛚	鳽
𫚭	鱲
𫚬	𩼶
𫚫	鱢
𫚪	鱊
𫚩	𩻬
𫚨	𩻗
𫚧	鰽
𫚦	鰫
𫚥	鰕
𫚤	鰦
𫚣	鯾
𫚢	鰋
𫚡	鯞
𫚠	䱧
𫚟	𩸡
𫚞	鯬
𫚝	𩸄
𫚜	䲅
𫚛	鮵
𫚚	鮿
𫚙	鯆
𫚘	𩻮
𫚗	鮯
𫚖	鮆
𫚕	鰤
𫚔	鮰
𫚓	鮤
𫚒	鮄
𫚑	鮅
𫚐	䱀
𫚏	䱁
𫚎	𩶁
𫚍	魵
𫚌	魦
𫚋	鱄
𫚊	鰑
𫚉	魟
𫚈	鱮
𫙂	𩯁
𫘽	鬠
𫘱	驨
𫘰	驙
𫘯	驓
𫘮	䮰
𫘭	騻
𫘬	騱
𫘫	騴
𫘪	騵
𫘩	騜
𫘨	騠
𫘧	騄
𫘦	騊
𫘥	騉
𫘤	騃
𫘣	駻
𫘡	駫
𫘠	駤
𫘟	駊
𫘞	駞
𫘝	駃
𫘜	馼
𫘛	馯
𫗵	饟
𫗴	饘
𫗳	𩝽
𫗱	䭑
𫗰	䭔
𫗯	餱
𫗮	餭
𫗭	餵
𫗬	餪
𫗫	餬
𫗪	餧
𫗩	饠
𫗨	𩛡
𫗧	餗
𫗦	餔
𫗥	餫
𫗤	𩛌
𫗣	飶
𫗢	飵
𫗡	𩚩
𫗠	餦
𫗟	䬧
𫗞	飦
𫗚	𩟗
𫗋	飋
𫗊	䬓
𫗉	𩗴
𫗈	𩗓
𫗇	䫻
𫖺	䫶
𫖹	顣
𫖸	願
𫖷	𩔑
𫖶	顅
𫖵	𩓥
𫖴	𩔳
𫖳	頵
𫖲	䫟
𫖱	䫀
𫖰	䫂
𫖯	頫
𫖮	顗
𫖭	𩒎
𫖬	䪾
𫖫	䪴
𫖪	𩑔
𫖖	𩏠
𫖕	韝
𫖔	韛
𫖓	𩏂
𫖒	韠
𫖑	𩎖
𫖇	鞾
𫖅	䪊
𫖃	靧
𫕨	𩅙
𫕥	霣
𫕚	𩀨
𫔽	𨼳
𫔶	闑
𫔵	䦯
𫔴	閵
𫔲	𨴹
𫔰	閞
𫔯	閗
𫔮	閒
𫔭	開
𫔖	𨲳
𫔕	𨰥
𫔔	鑴
𫔓	𨯟
𫔒	𨮳
𫔑	𨭖
𫔐	𨭸
𫔏	𨬖
𫔎	鐍
𫔍	鐇
𫔌	鏾
𫔋	䥗
𫔊	鏥
𫔉	𨰃
𫔈	鎙
𫔇	鎞
𫔆	䥯
𫔅	鎍
𫔄	鍒
𫔃	𨰲
𫔂	鍉
𫔁	鐼
𫔀	鍊
𫓿	𨨢
𫓾	錥
𫓽	錝
𫓼	𨨛
𫓻	錜
𫓺	鐪
𫓹	錤
𫓸	錽
𫓷	𫒡
𫓶	鋗
𫓵	鋠
𫓴	鉾
𫓳	𨰋
𫓲	銁
𫓱	鐈
𫓰	銊
𫓯	銈
𫓮	𨪕
𫓭	鉠
𫓬	鉔
𫓫	𨥟
𫓪	鈆
𫓩	鏦
𫓨	鈛
𫓧	鈇
𫓦	釨
𫓥	釟
𫑷	醶
𫑡	鄳
𫑘	鄟
𫐷	遱
𫐙	轠
𫐘	轗
𫐗	轐
𫐖	轇
𫐕	轊
𫐔	𨍰
𫐓	輮
𫐒	輷
𫐑	輨
𫐐	輗
𫐏	輖
𫐎	輢
𫐍	𨌈
𫐌	軿
𫐋	𨎌
𫐊	軬
𫐉	軨
𫐈	軷
𫐇	軜
𫐆	轣
𫐅	軕
𫐄	軏
𫏨	𨇤
𫏞	𨇰
𫏕	𨆪
𫏑	𨇽
𫏐	蹔
𫏌	𨂐
𫏋	蹻
𫏆	蹳
𫏃	䠆
𫎺	䟃
𫎸	𧽯
𫎳	䟆
𫎱	䟐
𫎭	䞓
𫎬	贑
𫎫	贉
𫎪	䞋
𫎩	賝
𫎨	𧸘
𫎧	䝭
𫎦	贚
𫎌	貗
𫎆	豵
𫍿	譾
𫍾	𧭈
𫍽	譞
𫍼	𧬤
𫍻	譆
𫍺	𧫝
𫍹	謯
𫍸	謆
𫍷	謉
𫍶	𧩼
𫍵	謸
𫍴	謱
𫍳	諥
𫍲	謏
𫍱	諯
𫍰	諰
𫍯	諴
𫍮	誳
𫍭	𧩕
𫍬	誷
𫍫	䛳
𫍪	誋
𫍩	諣
𫍨	誫
𫍧	誺
𫍦	譨
𫍥	誂
𫍤	譑
𫍣	詷
𫍢	譊
𫍡	詑
𫍠	䛄
𫍟	𧦧
𫍞	𧦝
𫍝	諫
𫍜	詓
𫍛	訜
𫍚	訞
𫍙	訑
𫍐	𧭹
𫌯	䚩
𫌭	覹
𫌬	𧢄
𫌫	𧡴
𫌪	覛
𫌨	覼
𫌋	𧞫
𫌇	襵
𫌀	襀
𫋻	襘
𫋹	襓
𫋷	襗
𫋲	䙔
𫋌	蟘
𫋇	蟂
𫊻	蟳
𫊹	𧒯
𫊸	蟜
𫊮	蠦
𫊪	䗅
𫉄	藷
𫉁	薆
𫈵	蕝
𫈟	蔯
𫈎	葝
𫈉	蕳
𫇽	蕽
𫇴	蒭
𫇭	蔿
𫇪	𦱌
𫇛	艣
𫇘	𦧺
𫆫	𦡝
𫆝	𦟼
𫆏	聻
𫅼	𦔖
𫅭	䎙
𫅥	𦒀
𫅗	羵
𫅅	䍤
𫄹	纗
𫄸	纁
𫄷	繶
𫄶	繈
𫄵	𦅈
𫄴	繂
𫄳	縰
𫄲	縸
𫄱	繬
𫄰	縍
𫄯	𦃩
𫄮	䋼
𫄭	緮
𫄬	緤
𫄫	綟
𫄪	𦅇
𫄩	䋦
𫄨	絺
𫄧	綖
𫄦	𦀖
𫄥	纚
𫄤	繨
𫄣	繷
𫄢	絥
𫄡	絧
𫄠	絙
𫄟	絁
𫄞	䋔
𫄝	𥾯
𫄜	䋃
𫄛	紟
𫄚	䊺
𫄙	糺
𫃗	𩏷
𫂿	𥻦
𫂖	𥴨
𫂈	䉬
𫂆	簂
𫂃	簢
𫁺	𥴼
𫁷	䉶
𫁳	𥯤
𫁲	䉑
𫁱	𥶽
𫁡	鴗
𫁟	竱
𫁂	䆉
𫀮	𥢷
𫀬	䅳
𫀨	䅐
𫀓	𥜐
𫀌	𥜰
𪿵	𥗇
𪿫	礮
𪿞	𥖲
𪿊	𥏝
𪾸	矉
𪾦	矑
𪾣	眝
𪾢	睍
𪾔	盨
𪽷	瘱
𪽴	𤺔
𪽮	㿖
𪽭	𤷃
𪽪	痮
𪽝	𤳷
𪽈	畼
𪼴	𤬅
𪼋	㻶
𪻺	璝
𪻲	瑻
𪻨	瓄
𪻐	瑽
𪺽	猌
𪺻	㺜
𪺸	𤠮
𪺷	獊
𪺭	犞
𪺪	𤜆
𪺣	𤘀
𪹹	𤒻
𪹳	爥
𪹠	𤓌
𪹀	𤑹
𪸩	煇
𪸕	熂
𪷽	灒
𪷍	㵾
𪶮	𣽏
𪶒	𤄷
𪶄	溡
𪵱	濿
𪵣	霼
𪵑	毊
𪴙	欑
𪳗	𣜬
𪳍	欇
𪲮	櫠
𪲛	檵
𪲔	欐
𪲎	櫅
𪱷	梖
𪱥	膹
𪰶	曊
𪯋	㪎
𪮶	攋
𪮳	𢺳
𪮖	撧
𪮋	㩋
𪮃	㨻
𪭾	撊
𪭵	掚
𪭯	𢶒
𪭧	擟
𪭢	摐
𪭝	𢯷
𪬯	𢤿
𪬚	𢣐
𪫺	憸
𪫷	㦞
𪫡	𢤩
𪫌	徿
𪪼	彃
𪪴	𢍰
𪪞	廧
𪪑	㢗
𪪏	廬
𪩸	幩
𪩷	幝
𪩛	𡿖
𪩘	巘
𪩎	巊
𪩇	㟺
𪨹	𡹬
𪨷	巗
𪨶	輋
𪨩	𡸗
𪨧	崙
𪨗	屩
𪨊	㞞
𪧘	寠
𪧀	孾
𪥿	嬻
𪥰	嬣
𪥫	孇
𪥠	𧹈
𪤚	壣
𪤄	𡓁
𪣻	塿
𪣒	堚
𪣆	埬
𪢸	墲
𪢮	圞
𪢠	囒
𪢖	𡅯
𪢕	嚽
𪢒	𡂡
𪢐	𡃤
𪢌	㘓
𪡺	𡃄
𪡞	嘳
𪡛	㗿
𪡏	嗹
𪡋	噞
𪡃	嘪
𪡀	嘺
𪠽	噹
𪠺	𠽃
𪠸	嚛
𪠵	㖮
𪠳	唓
𪠡	𠬙
𪠟	㓄
𪠀	𧷎
𪟝	勣
𪟎	㔋
𪞝	凙
𪜎	𠿕
𪚐	𪘯
𪚏	𪘀
𪔭	𪔵
𪑅	䵳
𪎌	麳
𪎋	䴴
𪎊	麨
𪎉	麲
𪎈	䴬
𪉕	𪇳
𪉔	𪄆
𪉒	𪄕
𪉑	鷔
𪉐	𪃍
𪉏	𪃏
𪉎	𪂆
𪉍	鵚
𪉌	𪁖
𪉋	𪀾
𪉊	鷨
𪉉	𪁈
𪉈	鴜
𪉆	鴲
𪉅	𪀦
𪉄	𩿪
𪉃	鳼
𪉂	䲰
𩾎	𩽇
𩾌	鱇
𩾋	䱰
𩾊	䱬
𩾈	䱙
𩾇	鯱
𩾆	𩸦
𩾅	𩸃
𩾄	𩷰
𩾃	鮸
𩾂	䲖
𩾁	鯄
𩽿	𩶰
𩽾	鮟
𩽽	𩶱
𩽼	鯶
𩽻	𩵹
𩽺	𩵩
𩽹	魥
𩴌	𩴵
𩲒	𩳤
𩰰	𩰹
𩯒	𩯳
𩭹	鬖
𩬤	𩰀
𩬣	𩭙
𩩈	䯤
𩨐	𩧆
𩨏	䮳
𩨎	龭
𩨍	𩥇
𩨌	𩥑
𩨋	𩥄
𩨊	騚
𩨉	𩤲
𩨈	騟
𩨇	䮫
𩨆	𩤙
𩨅	𩤸
𩨄	騪
𩨃	騝
𩨂	驄
𩨁	䮞
𩨀	騔
𩧿	䮠
𩧼	𩣺
𩧻	𩣵
𩧺	駶
𩧸	𩣫
𩧶	𩣏
𩧵	𩢴
𩧴	駩
𩧳	𩢸
𩧲	駧
𩧱	𩥉
𩧰	䮝
𩧯	驋
𩧮	𩢾
𩧭	䭿
𩧬	𩢡
𩧫	駚
𩧪	䮾
𩧩	𩤊
𩧨	駎
𩧦	𩡺
𩡖	𩡣
𩠠	𩠴
𩠏	𩞦
𩠎	𩞄
𩠌	餸
𩠋	𩝔
𩠊	𩜵
𩠉	𩜇
𩠈	䭃
𩠇	䭀
𩠆	𩜦
𩠅	𩟐
𩠃	𩛩
𩠂	𩛆
𩠁	𩚵
𩠀	𩚥
𩟿	𩚛
𩙰	𩙈
𩙯	䬝
𩙮	䬘
𩙭	𩘝
𩙬	𩘺
𩙫	颾
𩙪	颷
𩙩	𩘀
𩙨	𩘹
𩙧	䬞
𩙦	𩗀
𩙥	颰
𩖗	䫴
𩖖	顃
𩖕	𩓣
𩓋	顂
𩐀	䪗
𩏿	䪘
𩏾	𩎢
𩏽	𩏪
𩏼	䪏
𨸟	䧢
𨸘	𨽏
𨸎	𨷲
𨸌	𨶮
𨸋	𨶲
𨸊	𨶏
𨸉	𨶀
𨸇	𨵸
𨸆	𨵩
𨸅	𨴗
𨸄	䦘
𨸃	閐
𨸂	閍
𨸁	𨳑
𨸀	𨳕
𨷿	䦳
𨱖	䥩
𨱕	𨮂
𨱔	鐏
𨱓	鐎
𨱒	鏉
𨱑	鐄
𨱐	𨫒
𨱏	鎝
𨱎	鍮
𨱍	鎯
𨱌	鏆
𨱋	錂
𨱊	𨧱
𨱉	鍄
𨱈	鋉
𨱇	銶
𨱆	龯
𨱅	鉁
𨱄	鈯
𨱃	鈲
𨱂	鈋
𨱁	鈠
𨱀	𨥛
𨰿	釳
𨰾	鎷
𨤰	𨤻
𨡺	𨣈
𨡙	𨢿
𨠨	𨣧
𨟳	𨣞
𨑹	䢨
𨐊	𨏥
𨐉	𨎮
𨐈	輄
𨐇	𨏠
𨐆	𨊻
𨐅	軗
𨉗	軉
𨅬	躝
𨅫	𨇞
𨅛	䠱
𨄄	𨈌
𨂺	𨈊
𨁴	𨅍
𨀱	𨄣
𨀁	躘
𧿈	𨇁
𧹗	贃
𧹖	賟
𧹕	䝻
𧹔	賬
𧹓	𧶔
𧹒	買
𧹑	䞈
𧳕	𧳟
𧮪	詀
𧝧	𧟀
𧝝	襰
𧜭	䙱
𧒭	𧔥
𧑏	蠾
𧏗	蠀
𧏖	蠙
𧌥	𧎈
𧉞	䗿
𧉐	𧕟
𦻕	蘟
𦶻	𦾟
𦶟	爇
𦰴	䕳
𦰏	蓧
𦨩	𦪽
𦟗	𦣎
𦝼	膢
𦛨	朥
𦍠	䍽
𦈡	繻
𦈠	䌥
𦈟	䌝
𦈞	䌟
𦈝	繏
𦈜	䌖
𦈛	繓
𦈚	縬
𦈙	䌰
𦈘	䌋
𦈗	𦃄
𦈖	䌈
𦈕	緰
𦈔	縎
𦈓	䋿
𦈒	𦂅
𦈑	緸
𦈐	縺
𦈏	緍
𦈎	繟
𦈌	綀
𦈋	綇
𦈉	緷
𦈈	𥿊
𥺇	𥽖
𥺅	䊭
𥹥	𥼽
𥱔	𥵃
𥮾	篸
𥮜	䉲
𥮋	𥸠
𥭉	𥵊
𥬠	篘
𥬞	籋
𥬀	䉙
𥫣	籅
𥩺	𥪂
𥩟	竚
𥧂	𥨐
𥞦	𥞵
𥐻	碙
𥐰	𥕥
𥐯	𥖅
𥐟	礒
𥎝	䂎
𥇢	䁪
𥆧	瞤
𥅿	𥊝
𥅴	䀹
𥅘	𥌃
𥁢	䀉
𤿲	麬
𤾀	皟
𤽯	㿧
𤻊	㿗
𤶧	𤸫
𤶊	癐
𤳄	𤳸
𤩽	瓛
𤦀	瓕
𤠋	㺏
𤞤	玁
𤞃	獩
𤝢	𤢟
𤙯	𤛮
𤎻	𤑳
𤎺	𤓎
𤋏	熡
𤊰	𤓩
𤊀	𤒎
𤈷	㷿
𤈶	熉
𤇹	熚
𤇭	爖
𤇄	熌
𤇃	爄
𤆢	㷍
𤆡	熓
𣽷	瀃
𣺽	𤁣
𣺼	灙
𣸣	濆
𣷷	𤅶
𣶭	𪷓
𣶫	𣿉
𣶩	澅
𣳆	㵗
𣲘	潕
𣲗	湋
𣱝	氭
𣯣	𣯩
𣭤	𣯴
𣨼	殢
𣞎	𣠩
𣚚	欘
𣘷	𣝕
𣘴	檭
𣘓	𣞻
𣘐	㯤
𣗙	㰙
𣗋	欓
𣗊	樠
𣔌	樤
𣓿	橯
𣒌	楇
𣑶	𣠲
𣐤	欍
𣐕	桱
𣏢	槫
𣎑	臗
𣍰	脥
𣍯	腪
𣍨	𦢈
𣈣	𣋋
𣆐	曥
𣃁	斸
𢽾	斅
𢭏	擣
𢬦	𢹿
𢬍	擫
𢫬	摋
𢫞	𢶫
𢫊	𢷮
𢧐	戰
𢢐	𤢻
𢠁	懎
𢛯	㦎
𢙓	懀
𢙒	憢
𢙑	𢠼
𢙐	憹
𢙏	愻
𢘞	𢣭
𢘝	𢣚
𢘙	𢤱
𢗓	㦛
𢋈	㢝
𡺄	嶘
𡺃	嶈
𡸃	𡽗
𡶴	嵼
𡳒	𦘧
𡳃	𡳳
𡭬	𡮣
𡭜	𡮉
𡥧	孻
𡠟	孎
𡞱	㜢
𡞋	㜗
𡝠	㜷
𡒄	壈
𡍣	𡔖
𡋤	壗
𡋗	𡑭
𡋀	𡓾
𠵾	㗲
𠵸	𡄣
𠴢	𡄔
𠴛	𡃕
𠲥	𡅏
𠱞	囃
𠰷	嚧
𠰱	㘉
𠯠	噅
𠯟	哯
𠮶	嗰
𠡠	勑
𠛾	𪟖
𠛆	𠞆
𠛅	剾
𠚳	𠠎
𠋆	儭
𠉗	𠏢
𠉂	㒓
𠇹	俓
𠆿	𠌥
𠆲	儣
𠀾	𠁞
鿔	鎶
鿒	鿓
鿏	䥑
鿎	䃮
龟	龜
龛	龕
龚	龔
龙	龍
龌	齷
龋	齲
龊	齪
龉	齬
龈	齦
龇	齜
龆	齠
龅	齙
龄	齡
龃	齟
龂	齗
龁	齕
龀	齔
齿	齒
齑	齏
齐	齊
鼹	鼴
鼍	鼉
鼌	鼂
鼋	黿
黾	黽
黪	黲
黩	黷
黡	黶
黉	黌
黄	黃
麽	麼
麺	麪
麹	麴
麸	麩
麦	麥
鹾	鹺
鹴	鸘
鹳	鸛
鹲	鸏
鹱	鸌
鹰	鷹
鹯	鸇
鹮	䴉
鹭	鷺
鹬	鷸
鹫	鷲
鹪	鷦
鹩	鷯
鹨	鷚
鹧	鷓
鹦	鸚
鹥	鷖
鹤	鶴
鹣	鶼
鹢	鷁
鹡	鶺
鹠	鶹
鹟	鶲
鹞	鷂
鹝	鷊
鹜	鶩
鹛	鶥
鹚	鷀
鹙	鶖
鹘	鶻
鹗	鶚
鹖	鶡
鹕	鶘
鹔	鷫
鹓	鵷
鹒	鶊
鹑	鶉
鹐	鵮
鹏	鵬
鹎	鵯
鹍	鵾
鹌	鵪
鹋	鶓
鹊	鵲
鹉	鵡
鹈	鵜
鹇	鷳
鹆	鵒
鹅	鵝
鹄	鵠
鹃	鵑
鹂	鸝
鹁	鵓
鹀	鵐
鸿	鴻
鸾	鸞
鸽	鴿
鸼	鵃
鸻	鴴
鸺	鵂
鸹	鴰
鸸	鴯
鸷	鷙
鸶	鷥
鸵	鴕
鸴	鷽
鸳	鴛
鸲	鴝
鸱	鴟
鸰	鴒
鸯	鴦
鸮	鴞
鸭	鴨
鸬	鸕
鸫	鶇
鸪	鴣
鸩	鴆
鸨	鴇
鸧	鶬
鸦	鴉
鸥	鷗
鸤	鳲
鸣	鳴
鸢	鳶
鸡	雞
鸠	鳩
鸟	鳥
鳤	䲘
鳣	鱣
鳢	鱧
鳡	鱤
鳠	鱯
鳟	鱒
鳞	鱗
鳝	鱔
鳜	鱖
鳛	鰼
鳚	䲁
鳙	鱅
鳘	鰵
鳗	鰻
鳖	鱉
鳕	鱈
鳔	鰾
鳓	鰳
鳒	鰜
鳑	鰟
鳐	鰩
鳏	鰥
鳎	鰨
鳍	鰭
鳌	鰲
鳋	鰠
鳊	鯿
鳉	鱂
鳈	鰁
鳇	鰉
鳆	鰒
鳅	鰍
鳄	鱷
鳃	鰓
鳂	鰃
鳁	鰮
鳀	鯷
鲿	鱨
鲾	鰏
鲽	鰈
鲼	鱝
鲻	鯔
鲺	鯴
鲹	鰺
鲸	鯨
鲷	鯛
鲶	鯰
鲵	鯢
鲴	鯝
鲳	鯧
鲲	鯤
鲱	鯡
鲰	鯫
鲯	鯕
鲮	鯪
鲭	鯖
鲬	鯒
鲫	鯽
鲪	鮶
鲩	鯇
鲨	鯊
鲧	鯀
鲦	鰷
鲥	鰣
鲤	鯉
鲣	鰹
鲢	鰱
鲡	鱺
鲠	鯁
鲟	鱘
鲞	鯗
鲝	鮺
鲜	鮮
鲛	鮫
鲚	鱭
鲙	鱠
鲘	鮜
鲗	鰂
鲖	鮦
鲕	鮞
鲔	鮪
鲓	鮳
鲒	鮚
鲑	鮭
鲐	鮐
鲏	鮍
鲎	鱟
鲍	鮑
鲌	鮊
鲋	鮒
鲊	鮓
鲉	鮋
鲈	鱸
鲇	鮎
鲆	鮃
鲅	鮁
鲄	魺
鲃	䰾
鲂	魴
鲁	魯
鲀	魨
鱿	魷
鱾	魢
鱽	魛
鱼	魚
魉	魎
魇	魘
鬶	鬹
鬓	鬢
髌	髕
髋	髖
髅	髏
骧	驤
骦	驦
骥	驥
骤	驟
骣	驏
骢	驄
骡	騾
骠	驃
骟	騸
骞	騫
骝	騮
骜	驁
骛	騖
骚	騷
骙	騤
骘	騭
骗	騙
骖	驂
骕	驌
骔	騌
骓	騅
骒	騍
骑	騎
骐	騏
骏	駿
骎	駸
骍	騂
验	驗
骋	騁
骊	驪
骉	驫
骈	駢
骇	駭
骆	駱
骅	驊
骄	驕
骃	駰
骂	罵
骁	驍
骀	駘
驿	驛
驾	駕
驽	駑
驼	駝
驻	駐
驺	騶
驹	駒
驸	駙
驷	駟
驶	駛
驵	駔
驴	驢
驳	駁
驲	馹
驱	驅
驰	馳
驯	馴
驮	馱
驭	馭
马	馬
馕	饢
馔	饌
馓	饊
馒	饅
馑	饉
馐	饈
馏	餾
馎	餺
馍	饃
馌	饁
馋	饞
馊	餿
馉	餶
馈	饋
馇	餷
馆	館
馅	餡
馄	餛
馃	餜
馂	餕
馁	餒
馀	餘
饿	餓
饾	餖
饽	餑
饼	餅
饻	餏
饺	餃
饹	餎
饸	餄
饷	餉
饶	饒
饵	餌
饴	飴
饳	飿
饲	飼
饱	飽
饰	飾
饯	餞
饮	飲
饭	飯
饬	飭
饫	飫
饪	飪
饩	餼
饨	飩
饧	餳
饦	飥
饥	飢
饤	飣
饣	飠
餍	饜
飨	饗
飞	飛
飚	飈
飙	飆
飘	飄
飗	飀
飖	颻
飕	颼
飔	颸
飓	颶
飒	颯
飑	颮
飐	颭
飏	颺
风	風
颧	顴
颦	顰
颥	顬
颤	顫
颣	纇
颢	顥
颡	顙
颠	顛
颟	顢
颞	顳
额	額
颜	顏
颛	顓
颚	顎
颙	顒
题	題
颗	顆
颖	穎
颕	頴
颔	頷
颓	頹
颒	頮
频	頻
颐	頤
颏	頦
颎	熲
颍	潁
颌	頜
颋	頲
颊	頰
颉	頡
颈	頸
颇	頗
领	領
颅	顱
预	預
颃	頏
颂	頌
颁	頒
颀	頎
顿	頓
顾	顧
顽	頑
顼	頊
须	須
顺	順
项	項
顸	頇
顷	頃
顶	頂
页	頁
韵	韻
韬	韜
韫	韞
韪	韙
韩	韓
韨	韍
韧	韌
韦	韋
鞲	韝
鞯	韉
鞒	鞽
鞑	韃
靥	靨
面	面
静	靜
靔	靝
靓	靚
霭	靄
霡	霢
霉	黴
霁	霽
雾	霧
雳	靂
雠	讎
雕	雕
雏	雛
雇	僱
难	難
隽	雋
隶	隸
隐	隱
随	隨
险	險
陨	隕
陧	隉
陦	隯
陕	陝
陉	陘
陈	陳
陇	隴
陆	陸
际	際
阶	階
阵	陣
阴	陰
阳	陽
队	隊
阛	闤
阚	闞
阙	闕
阘	闒
阗	闐
阖	闔
阕	闋
阔	闊
阓	闠
阒	闃
阑	闌
阐	闡
阏	閼
阎	閻
阍	閽
阌	閿
阋	鬩
阊	閶
阉	閹
阈	閾
阇	闍
阆	閬
阅	閱
阄	鬮
阃	閫
阂	閡
阁	閣
阀	閥
闿	闓
闾	閭
闽	閩
闼	闥
闻	聞
闺	閨
闹	鬧
闸	閘
闷	悶
闶	閌
闵	閔
间	間
闳	閎
闲	閒
闱	闈
闰	閏
闯	闖
问	問
闭	閉
闬	閈
闫	閆
闪	閃
闩	閂
门	門
长	長
镶	鑲
镵	鑱
镴	鑞
镳	鑣
镲	鑔
镱	鐿
镰	鐮
镯	鐲
镮	鐶
镭	鐳
镬	鑊
镫	鐙
镪	鏹
镩	鑹
镨	鐠
镧	鑭
镦	鐓
镥	鑥
镤	鏷
镣	鐐
镢	钁
镡	鐔
镠	鏐
镟	鏇
镞	鏃
镝	鏑
镜	鏡
镛	鏞
镚	鏰
镙	鏍
镘	鏝
镗	鏜
镖	鏢
镕	鎔
镔	鑌
镓	鎵
镒	鎰
镑	鎊
镐	鎬
镏	鎦
镎	鎿
镍	鎳
镌	鐫
镋	钂
镊	鑷
镉	鎘
镈	鎛
镇	鎮
镆	鏌
镅	鎇
镄	鐨
镃	鎡
镂	鏤
镁	鎂
镀	鍍
锿	鎄
锾	鍰
锽	鍠
锼	鎪
锻	鍛
锺	鍾
锹	鍬
锸	鍤
锷	鍔
锶	鍶
锵	鏘
锴	鍇
锳	鍈
锲	鍥
锱	錙
锰	錳
锯	鋸
键	鍵
锭	錠
锬	錟
锫	錇
锪	鍃
锩	錈
锨	鍁
锧	鑕
锦	錦
锥	錐
锤	錘
锣	鑼
锢	錮
锡	錫
锠	錩
锟	錕
锞	錁
锝	鍀
锜	錡
锛	錛
锚	錨
错	錯
锘	鍩
锗	鍺
锖	錆
锕	錒
锔	鋦
锓	鋟
锒	鋃
锑	銻
锐	銳
锏	鐧
锎	鐦
锍	鋶
锌	鋅
锋	鋒
锊	鋝
锉	銼
锈	鏽
锇	鋨
锆	鋯
锅	鍋
锄	鋤
锃	鋥
锂	鋰
锁	鎖
销	銷
铿	鏗
链	鏈
铽	鋱
铼	錸
铻	鋙
铺	鋪
铹	鐒
铸	鑄
铷	銣
银	銀
铵	銨
铴	鐋
铳	銃
铲	鏟
铱	銥
铰	鉸
铯	銫
铮	錚
铭	銘
铬	鉻
铫	銚
铪	鉿
铩	鎩
铨	銓
铧	鏵
铦	銛
铥	銩
铤	鋌
铣	銑
铢	銖
铡	鍘
铠	鎧
铟	銦
铞	銱
铝	鋁
铜	銅
铛	鐺
铚	銍
铙	鐃
铘	鋣
铗	鋏
铖	鋮
铕	銪
铔	錏
铓	鋩
铒	鉺
铑	銠
铐	銬
铏	鉶
铎	鐸
铍	鈹
铌	鈮
铋	鉍
铊	鉈
铉	鉉
铈	鈰
铇	鉋
铆	鉚
铅	鉛
铄	鑠
铃	鈴
铂	鉑
铁	鐵
铀	鈾
钿	鈿
钾	鉀
钽	鉭
钼	鉬
钻	鑽
钺	鉞
钹	鈸
钸	鈽
钷	鉕
钶	鈳
钵	鉢
钴	鈷
钳	鉗
钲	鉦
钱	錢
钰	鈺
钯	鈀
钮	鈕
钭	鈄
钬	鈥
钫	鈁
钪	鈧
钩	鉤
钨	鎢
钧	鈞
钦	欽
钥	鑰
钤	鈐
钣	鈑
钢	鋼
钡	鋇
钠	鈉
钟	鍾
钞	鈔
钝	鈍
钜	鉅
钛	鈦
钚	鈈
钙	鈣
钘	鈃
钗	釵
钖	鍚
钕	釹
钔	鍆
钓	釣
钒	釩
钑	鈒
钐	釤
钏	釧
钎	釺
钍	釷
钌	釕
钋	釙
钊	釗
钉	釘
针	針
钇	釔
钆	釓
钅	釒
錾	鏨
銮	鑾
鉴	鑑
里	裏
释	釋
采	採
醖	醞
酿	釀
酾	釃
酽	釅
酸	酸
酱	醬
酦	醱
酝	醞
酂	酇
郸	鄲
郧	鄖
郦	酈
郓	鄆
郑	鄭
郐	鄶
郏	郟
郁	鬱
邻	鄰
邺	鄴
邹	鄒
邮	郵
邬	鄔
邝	鄺
邓	鄧
遥	遙
遗	遺
逻	邏
逦	邐
递	遞
逊	遜
选	選
适	適
迹	跡
迳	逕
迩	邇
迟	遲
连	連
违	違
远	遠
进	進
这	這
还	還
运	運
迈	邁
过	過
迁	遷
达	達
辽	遼
边	邊
辫	辮
辩	辯
辟	闢
辞	辭
辚	轔
辙	轍
辘	轆
辗	輾
辖	轄
辕	轅
辔	轡
输	輸
辒	轀
辑	輯
辐	輻
辏	輳
辎	輜
辍	輟
辌	輬
辋	輞
辊	輥
辉	輝
辈	輩
辇	輦
辆	輛
辅	輔
辄	輒
较	較
辂	輅
辁	輇
辀	輈
轿	轎
轾	輊
载	載
轼	軾
轻	輕
轺	軺
轹	轢
轸	軫
轷	軤
轶	軼
轵	軹
轴	軸
轳	轤
轲	軻
轱	軲
轰	轟
软	軟
轮	輪
轭	軛
转	轉
轫	軔
轪	軑
轩	軒
轨	軌
轧	軋
车	車
輼	轀
躯	軀
躜	躦
躏	躪
蹿	躥
蹰	躕
蹒	蹣
蹑	躡
踯	躑
踬	躓
踪	蹤
踌	躊
跻	躋
跹	躚
跸	蹕
跷	蹺
跶	躂
践	踐
跞	躒
跖	蹠
跄	蹌
跃	躍
趸	躉
趱	趲
趋	趨
赶	趕
赵	趙
赪	赬
赣	贛
赢	贏
赡	贍
赠	贈
赟	贇
赞	贊
赝	贗
赜	賾
赛	賽
赚	賺
赙	賻
赘	贅
赗	賵
赖	賴
赕	賧
赔	賠
赓	賡
赒	賙
赑	贔
赐	賜
赏	賞
赎	贖
赍	齎
赌	賭
赋	賦
赊	賒
赉	賚
赈	賑
赇	賕
赆	贐
赅	賅
资	資
赃	贓
赂	賂
赁	賃
赀	貲
贿	賄
贾	賈
贽	贄
贼	賊
贻	貽
贺	賀
费	費
贸	貿
贷	貸
贶	貺
贵	貴
贴	貼
贳	貰
贲	賁
贱	賤
贰	貳
贯	貫
贮	貯
购	購
贬	貶
贫	貧
贪	貪
贩	販
质	質
货	貨
账	賬
败	敗
贤	賢
责	責
财	財
贡	貢
贠	貟
负	負
贞	貞
贝	貝
豮	豶
谷	谷
谶	讖
谵	譫
谴	譴
谳	讞
谲	譎
谱	譜
谰	讕
谯	譙
谮	譖
谭	譚
谬	謬
谫	譾
谪	謫
谩	謾
谨	謹
谧	謐
谦	謙
谥	諡
谤	謗
谣	謠
谢	謝
谡	謖
谠	讜
谟	謨
谞	諝
谝	諞
谜	謎
谛	諦
谚	諺
谙	諳
谘	諮
谗	讒
谖	諼
谕	諭
谔	諤
谓	謂
谒	謁
谑	謔
谐	諧
谏	諫
谎	謊
谍	諜
谌	諶
谋	謀
谊	誼
谉	讅
谈	談
谇	誶
谆	諄
谅	諒
谄	諂
调	調
谂	諗
谁	誰
谀	諛
诿	諉
课	課
诽	誹
诼	諑
读	讀
诺	諾
诹	諏
诸	諸
请	請
诶	誒
诵	誦
说	說
诳	誑
诲	誨
诱	誘
诰	誥
误	誤
诮	誚
语	語
诬	誣
诫	誡
诪	譸
诩	詡
诨	諢
诧	詫
详	詳
该	該
诤	諍
诣	詣
询	詢
诡	詭
诠	詮
诟	詬
诞	誕
话	話
诜	詵
诛	誅
诚	誠
诙	詼
诘	詰
诗	詩
诖	詿
试	試
诔	誄
诓	誆
诒	詒
译	譯
诐	詖
诏	詔
诎	詘
词	詞
诌	謅
诋	詆
诊	診
诉	訴
诈	詐
诇	詗
识	識
诅	詛
评	評
诃	訶
诂	詁
证	證
诀	訣
访	訪
设	設
讽	諷
讼	訟
讻	訩
论	論
讹	訛
许	許
讷	訥
讶	訝
讵	詎
讴	謳
讳	諱
讲	講
讱	訒
记	記
讯	訊
议	議
训	訓
讬	託
讫	訖
讪	訕
让	讓
讨	討
讧	訌
讦	訐
讥	譏
认	認
讣	訃
订	訂
计	計
讠	訁
誊	謄
誉	譽
詟	讋
訚	誾
觯	觶
触	觸
觞	觴
觑	覷
觐	覲
觏	覯
觎	覦
觍	覥
觌	覿
觋	覡
觊	覬
觉	覺
览	覽
觇	覘
视	視
觅	覓
规	規
觃	覎
观	觀
见	見
襕	襴
褴	襤
褛	褸
裥	襉
裤	褲
裣	襝
裢	褳
裈	褌
裆	襠
装	裝
袯	襏
袭	襲
袜	襪
袆	褘
袅	嫋
袄	襖
衮	袞
衬	襯
表	表
补	補
衔	銜
衅	釁
蟏	蠨
螨	蟎
螀	螿
蝾	蠑
蝼	螻
蝎	蠍
蝉	蟬
蝈	蟈
蝇	蠅
蜡	蠟
蜗	蝸
蜕	蛻
蛴	蠐
蛳	螄
蛲	蟯
蛱	蛺
蛰	蟄
蛮	蠻
蛏	蟶
蛎	蠣
蛊	蠱
蚬	蜆
蚝	蠔
蚕	蠶
蚃	蠁
蚂	螞
蚁	蟻
蚀	蝕
虿	蠆
虾	蝦
虽	雖
虱	蝨
虮	蟣
虬	虯
虫	蟲
虚	虛
虑	慮
虏	虜
蘖	櫱
藴	蘊
藓	蘚
薮	藪
蕴	蘊
蕲	蘄
蕰	薀
蔼	藹
蔺	藺
蔹	蘞
蔷	薔
蔑	蔑
蔂	虆
蓦	驀
蓥	鎣
蓣	蕷
蓠	蘺
蓟	薊
蓝	藍
蒙	蒙
蒏	醟
蒌	蔞
蒋	蔣
蒉	蕢
蒇	蕆
蒀	蒕
葱	蔥
萨	薩
萧	蕭
萦	縈
营	營
萤	螢
萝	蘿
萚	蘀
莼	蓴
莺	鶯
莹	瑩
莸	蕕
获	獲
莶	薟
莴	萵
莳	蒔
莲	蓮
莱	萊
莅	蒞
药	藥
荮	葤
荭	葒
荬	蕒
荫	蔭
荪	蓀
荩	藎
荨	蕁
荧	熒
荦	犖
荥	滎
荤	葷
荣	榮
荡	蕩
荠	薺
荟	薈
荞	蕎
荝	萴
荜	蓽
荛	蕘
荚	莢
荙	薘
荐	薦
荆	荊
茧	繭
茕	煢
茔	塋
茑	蔦
茏	蘢
茎	莖
范	範
苹	蘋
苧	薴
苔	苔
苏	蘇
苎	苧
苍	蒼
苌	萇
苋	莧
苈	藶
苇	葦
苁	蓯
芸	芸
芦	蘆
芜	蕪
芗	薌
芈	羋
节	節
艺	藝
艳	豔
艰	艱
舻	艫
舱	艙
舰	艦
舣	艤
舍	舍
舆	輿
致	致
臜	臢
膻	羶
膑	臏
腾	騰
腽	膃
腼	靦
腻	膩
腭	齶
腘	膕
腌	醃
腊	臘
脸	臉
脶	腡
脱	脫
脚	腳
脔	臠
脓	膿
脑	腦
脐	臍
脏	髒
脍	膾
脉	脈
胶	膠
胫	脛
胪	臚
胨	腖
胧	朧
胡	胡
胜	勝
背	背
胆	膽
胄	胄
胁	脅
胀	脹
肿	腫
肾	腎
肴	餚
肮	骯
肤	膚
肠	腸
肃	肅
聪	聰
聩	聵
联	聯
聍	聹
职	職
聋	聾
聂	聶
耻	恥
耸	聳
耧	耬
耢	耮
翚	翬
翙	翽
翘	翹
群	羣
羡	羨
羟	羥
羁	羈
罴	羆
罢	罷
罚	罰
罗	羅
网	網
罂	罌
缵	纘
缴	繳
缳	繯
缲	繰
缱	繾
缰	繮
缯	繒
缮	繕
缭	繚
缬	纈
缫	繅
缪	繆
缩	縮
缨	纓
缧	縲
缦	縵
缥	縹
缤	繽
缣	縑
缢	縊
缡	縭
缠	纏
缟	縞
缞	縗
缝	縫
缜	縝
缛	縟
缚	縛
缙	縉
缘	緣
缗	緡
编	編
缕	縷
缔	締
缓	緩
缒	縋
缑	緱
缐	線
缏	緶
缎	緞
缍	綞
缌	緦
缋	繢
缊	縕
缉	緝
缈	緲
缇	緹
缆	纜
缅	緬
缄	緘
缃	緗
缂	緙
缁	緇
缀	綴
绿	綠
绾	綰
绽	綻
综	綜
绻	綣
绺	綹
绹	綯
绸	綢
绷	繃
绶	綬
绵	綿
维	維
绳	繩
绲	緄
绱	鞝
绰	綽
绯	緋
绮	綺
续	續
绬	緓
绫	綾
绪	緒
绩	績
绨	綈
继	繼
绦	絛
绥	綏
绤	綌
绣	繡
绢	絹
绡	綃
绠	綆
统	統
绞	絞
绝	絕
络	絡
绛	絳
绚	絢
给	給
绘	繪
绗	絎
绖	絰
绕	繞
绔	絝
结	結
绒	絨
绑	綁
绐	紿
经	經
绎	繹
绍	紹
绌	絀
绋	紼
绊	絆
绉	縐
终	終
织	織
细	細
绅	紳
组	組
练	練
绂	紱
绁	紲
绀	紺
线	線
纾	紓
纽	紐
纼	紖
纻	紵
纺	紡
纹	紋
纸	紙
纷	紛
纶	綸
纵	縱
纴	紝
纳	納
纲	綱
纱	紗
纰	紕
纯	純
纮	紘
纭	紜
纬	緯
纫	紉
纪	紀
纩	纊
纨	紈
级	級
约	約
纥	紇
纤	纖
纣	紂
红	紅
纡	紆
纠	糾
纟	糹
縆	緪
緼	縕
絷	縶
紧	緊
系	系
糍	餈
糇	餱
糁	糝
粽	糉
粮	糧
粪	糞
粤	粵
粝	糲
粜	糶
籼	秈
类	類
籴	糴
籁	籟
簖	籪
篱	籬
篯	籛
篮	籃
篓	簍
篑	簣
箫	簫
箪	簞
箩	籮
箨	籜
箧	篋
箦	簀
箓	籙
简	簡
筿	篠
签	籤
筼	篔
筹	籌
筝	箏
筜	簹
筛	篩
筚	篳
筑	築
笾	籩
笼	籠
笺	箋
笕	筧
笔	筆
笋	筍
笃	篤
竞	競
竖	豎
窭	窶
窦	竇
窥	窺
窝	窩
窜	竄
窑	窯
窎	窵
窍	竅
窃	竊
穷	窮
穞	穭
穑	穡
稳	穩
稣	穌
税	稅
稆	穭
秾	穠
秽	穢
称	稱
积	積
秘	祕
种	種
秋	秋
秆	稈
秃	禿
私	私
离	離
禅	禪
禄	祿
禀	稟
祸	禍
祷	禱
祯	禎
祢	禰
祎	禕
祃	禡
礼	禮
碱	鹼
碜	磣
碛	磧
碍	礙
硷	礆
硵	磠
确	確
硚	礄
硙	磑
硗	磽
硖	硤
硕	碩
硁	硜
础	礎
砾	礫
砻	礱
砺	礪
砜	碸
砚	硯
砗	硨
砖	磚
码	碼
砀	碭
矿	礦
矾	礬
矶	磯
矫	矯
矩	矩
瞩	矚
瞒	瞞
瞆	瞶
睑	瞼
睐	睞
睁	睜
眬	矓
眦	眥
眍	瞘
盘	盤
盗	盜
盖	蓋
监	監
盐	鹽
盏	盞
皲	皸
皱	皺
皑	皚
皂	皁
癫	癲
癣	癬
癞	癩
瘿	癭
瘾	癮
瘫	癱
瘪	癟
瘘	瘻
瘗	瘞
瘆	瘮
瘅	癉
痴	癡
痫	癇
痪	瘓
痨	癆
痖	瘂
痒	癢
痉	痙
痈	癰
症	症
疴	痾
疱	皰
疯	瘋
疮	瘡
疭	瘲
疬	癧
疡	瘍
疠	癘
疟	瘧
疗	療
疖	癤
畴	疇
畅	暢
画	畫
电	電
瓯	甌
瓮	甕
瓒	瓚
璎	瓔
璇	璇
瑸	璸
瑷	璦
瑶	瑤
琼	瓊
琐	瑣
琏	璉
琎	璡
珲	琿
珰	璫
珑	瓏
珐	琺
玺	璽
玱	瑲
现	現
环	環
玮	瑋
玩	玩
玛	瑪
玚	瑒
玙	璵
玑	璣
獭	獺
献	獻
猬	蝟
猫	貓
猪	豬
猡	玀
猕	獼
猎	獵
猃	獫
狲	猻
狱	獄
狰	猙
狯	獪
狮	獅
狭	狹
独	獨
狞	獰
狝	獮
狈	狽
犹	猶
犸	獁
犷	獷
状	狀
犊	犢
牺	犧
牵	牽
牦	犛
牍	牘
爷	爺
爱	愛
熏	燻
煴	熅
焘	燾
焖	燜
焕	煥
热	熱
烬	燼
烫	燙
烩	燴
烨	燁
烧	燒
烦	煩
烟	煙
烛	燭
烃	烴
烂	爛
烁	爍
炽	熾
炼	煉
点	點
炝	熗
炜	煒
炖	燉
炉	爐
炀	煬
灿	燦
灾	災
灶	竈
灵	靈
灯	燈
灭	滅
灏	灝
濒	瀕
濑	瀨
澜	瀾
澛	瀂
潴	瀦
潜	潛
潍	濰
潋	瀲
潇	瀟
潆	瀠
漓	漓
滪	澦
滩	灘
滨	濱
滦	灤
滥	濫
滤	濾
滢	瀅
满	滿
滠	灄
滟	灩
滞	滯
滚	滾
滗	潷
溇	漊
溆	漵
溅	濺
溃	潰
溁	濚
湿	溼
湾	灣
游	遊
温	溫
渗	滲
渖	瀋
渔	漁
渑	澠
渐	漸
渎	瀆
渍	漬
渌	淥
渊	淵
淀	澱
涩	澀
涨	漲
涧	澗
润	潤
涤	滌
涣	渙
涢	溳
涡	渦
涠	潿
涟	漣
涞	淶
涝	澇
涛	濤
涚	涗
涌	湧
涂	塗
浕	濜
浔	潯
浓	濃
浒	滸
浑	渾
浐	滻
浏	瀏
济	濟
浍	澮
测	測
浊	濁
浉	溮
浈	湞
浇	澆
浆	漿
浅	淺
浃	浹
洼	窪
洒	灑
洁	潔
泾	涇
泽	澤
泼	潑
泻	瀉
泺	濼
泸	瀘
泷	瀧
泶	澩
泪	淚
注	注
泞	濘
泛	泛
沾	沾
沪	滬
沩	潙
沨	渢
沧	滄
沦	淪
沥	瀝
沤	漚
沣	灃
没	沒
沟	溝
沈	沈
沄	澐
汹	洶
汤	湯
汉	漢
汇	匯
氲	氳
氩	氬
氢	氫
气	氣
氇	氌
毶	𣯶
毵	毿
毡	氈
毙	斃
毕	畢
毂	轂
毁	毀
殴	毆
殡	殯
殚	殫
殓	殮
殒	殞
残	殘
殇	殤
殁	歿
歼	殲
欲	欲
欧	歐
欤	歟
欢	歡
檩	檁
橼	櫞
橹	櫓
橱	櫥
橥	櫫
樱	櫻
樯	檣
横	橫
槠	櫧
槟	檳
槛	檻
槚	檟
榝	樧
榉	櫸
榈	櫚
榇	櫬
榅	榲
榄	欖
楼	樓
椮	槮
椭	橢
椫	樿
椤	欏
椢	槶
椠	槧
椟	櫝
椝	槼
椁	槨
棂	欞
棁	梲
检	檢
梿	槤
梾	棶
梼	檮
梦	夢
梁	梁
桪	樳
桩	樁
桨	槳
桧	檜
桦	樺
桥	橋
桤	榿
档	檔
桢	楨
桡	橈
桠	椏
栾	欒
核	核
样	樣
栗	慄
栖	棲
树	樹
栏	欄
栎	櫟
栌	櫨
栋	棟
栊	櫳
栉	櫛
栈	棧
标	標
栅	柵
栀	梔
柽	檉
柠	檸
柜	櫃
枭	梟
枫	楓
枪	槍
枨	棖
枧	梘
枥	櫪
枣	棗
枢	樞
枞	樅
构	構
极	極
板	板
松	松
杰	傑
杯	杯
杩	榪
杨	楊
来	來
条	條
杠	槓
杆	杆
权	權
杂	雜
杀	殺
机	機
朴	樸
朱	朱
术	術
曲	曲
暧	曖
暗	暗
暅	𣈶
暂	暫
晖	暉
晕	暈
晔	曄
晓	曉
晒	曬
晋	晉
显	顯
昽	曨
昼	晝
昵	暱
昙	曇
昆	昆
旸	暘
旷	曠
时	時
旧	舊
无	無
旋	旋
断	斷
斩	斬
斗	鬥
斓	斕
斋	齋
数	數
敩	斆
敛	斂
敚	敓
敌	敵
攒	攢
擞	擻
擜	㩵
撺	攛
撸	擼
撷	擷
撵	攆
撑	撐
撄	攖
摊	攤
摈	擯
摇	搖
摆	擺
摅	攄
摄	攝
携	攜
搜	搜
搅	攪
搄	揯
搂	摟
搁	擱
搀	攙
揿	撳
揾	搵
揽	攬
掼	摜
掺	摻
掸	撣
掷	擲
掴	摑
掳	擄
据	據
捣	搗
换	換
捡	撿
损	損
捞	撈
捝	挩
挽	挽
挨	挨
挦	撏
挥	揮
挤	擠
挣	掙
挢	撟
挡	擋
挠	撓
挟	挾
挞	撻
挝	撾
挜	掗
挛	攣
挚	摯
挂	掛
择	擇
拨	撥
拧	擰
拦	攔
拥	擁
拣	揀
拢	攏
拟	擬
拐	拐
担	擔
抵	抵
报	報
护	護
抢	搶
抡	掄
抠	摳
抟	摶
抛	拋
抚	撫
折	折
扰	擾
扬	揚
扫	掃
扪	捫
扩	擴
执	執
扣	扣
托	託
扑	撲
扎	扎
才	才
户	戶
戯	戱
戬	戩
戚	戚
战	戰
戗	戧
戏	戲
戋	戔
戆	戇
懔	懍
懒	懶
懑	懣
慭	憖
慑	懾
愿	願
愦	憒
愤	憤
愠	慍
愈	愈
惯	慣
惮	憚
惭	慚
惬	愜
惫	憊
惩	懲
惨	慘
惧	懼
惊	驚
悯	憫
悮	悞
悭	慳
悬	懸
悫	愨
悦	悅
恽	惲
恼	惱
恻	惻
恺	愷
恹	懨
恸	慟
恶	惡
恳	懇
恤	恤
恒	恆
恋	戀
怿	懌
怼	懟
总	總
怜	憐
怆	愴
怅	悵
怄	慪
怃	憮
怂	慫
态	態
怀	懷
忾	愾
念	念
忧	憂
志	志
忏	懺
忆	憶
御	御
徕	徠
径	徑
征	徵
彻	徹
彩	彩
彨	彲
彦	彥
彟	彠
录	錄
当	當
归	歸
强	強
弹	彈
弯	彎
弪	弳
弦	弦
弥	彌
张	張
弑	弒
弃	棄
异	異
开	開
廪	廩
庼	廎
庵	庵
废	廢
庞	龐
庙	廟
应	應
库	庫
庑	廡
庐	廬
床	牀
庆	慶
庄	莊
广	廣
幸	幸
并	並
干	幹
幂	冪
帼	幗
帻	幘
帱	幬
帮	幫
席	席
帧	幀
带	帶
帜	幟
帘	簾
帐	帳
帏	幃
师	師
帅	帥
布	布
币	幣
巯	巰
巩	鞏
巨	巨
巅	巔
嵝	嶁
嵚	嶔
嵘	嶸
崭	嶄
崄	嶮
崃	崍
崂	嶗
峰	峯
峦	巒
峥	崢
峤	嶠
峣	嶢
峡	峽
峄	嶧
峃	嶨
岿	巋
岽	崬
岳	嶽
岭	嶺
岩	巖
岛	島
岚	嵐
岘	峴
岗	崗
岖	嶇
岂	豈
岁	歲
屿	嶼
屦	屨
屡	屢
属	屬
届	屆
屉	屜
屃	屓
层	層
局	局
尽	盡
尸	屍
尴	尷
尧	堯
尝	嘗
尘	塵
尔	爾
将	將
寿	壽
导	導
寻	尋
对	對
寝	寢
宾	賓
宽	寬
家	家
宫	宮
宪	憲
审	審
宠	寵
实	實
宝	寶
它	它
宁	寧
孪	孿
学	學
孙	孫
嬷	嬤
嫱	嬙
嫔	嬪
嫒	嬡
媭	嬃
媪	媼
婶	嬸
婵	嬋
婴	嬰
婳	嫿
娴	嫺
娲	媧
娱	娛
娘	娘
娈	孌
娇	嬌
娆	嬈
娅	婭
娄	婁
姹	奼
姜	姜
姗	姍
妫	嬀
妪	嫗
妩	嫵
妈	媽
妇	婦
妆	妝
奸	奸
奥	奧
奖	獎
奋	奮
奂	奐
奁	奩
夺	奪
夹	夾
夸	誇
头	頭
夫	夫
够	夠
复	復
备	備
处	處
壸	壼
壶	壺
壳	殼
声	聲
壮	壯
墙	牆
塆	壪
堕	墮
堑	塹
埚	堝
埙	壎
埘	塒
垴	堖
垲	塏
垱	壋
垯	墶
垭	埡
垫	墊
垩	堊
垦	墾
垒	壘
垆	壚
垅	壠
垄	壟
坠	墜
坟	墳
坞	塢
坝	壩
坜	壢
坛	壇
坚	堅
块	塊
坏	壞
场	場
圹	壙
圣	聖
圆	圓
图	圖
国	國
囵	圇
围	圍
囱	囪
困	困
园	園
团	團
回	回
嚣	囂
噪	噪
噜	嚕
嘱	囑
嘤	嚶
嘘	噓
嗳	噯
嗫	囁
喾	嚳
喽	嘍
喷	噴
喂	喂
啸	嘯
啴	嘽
啰	囉
啯	嘓
啮	齧
啭	囀
啬	嗇
啧	嘖
唤	喚
唢	嗩
唡	啢
唠	嘮
唝	嗊
唛	嘜
唇	脣
哟	喲
哝	噥
哜	嚌
哙	噲
哗	譁
哕	噦
哔	嗶
哓	嘵
哒	噠
哑	啞
响	響
哄	哄
咽	咽
咸	鹹
咨	諮
咤	吒
咝	噝
咛	嚀
咙	嚨
咏	詠
周	周
呜	嗚
呛	嗆
呙	咼
员	員
呗	唄
呖	嚦
呕	嘔
呓	囈
呒	嘸
呐	吶
吴	吳
启	啓
听	聽
吨	噸
吗	嗎
吕	呂
吓	嚇
向	向
后	後
同	同
吊	吊
合	合
吃	喫
吁	籲
叽	嘰
叹	嘆
号	號
叶	葉
台	臺
只	只
叠	疊
叙	敘
变	變
发	發
双	雙
叇	靆
叆	靉
参	參
叁	叄
县	縣
厮	廝
厩	廄
厨	廚
厦	廈
厣	厴
厢	廂
厘	釐
厕	廁
厐	龎
厍	厙
厌	厭
压	壓
厉	厲
历	歷
厅	廳
厂	廠
卺	巹
卷	卷
却	卻
卫	衛
卧	臥
卤	滷
卢	盧
占	佔
卜	卜
卖	賣
单	單
协	協
华	華
升	升
千	千
医	醫
区	區
匮	匱
匦	匭
匀	勻
勚	勩
勋	勳
势	勢
劳	勞
劲	勁
励	勵
动	動
劢	勱
务	務
办	辦
劝	勸
剧	劇
剥	剝
剑	劍
剐	剮
剂	劑
剀	剴
刿	劌
刾	㓨
刽	劊
刹	剎
制	制
刮	刮
刭	剄
刬	剗
别	別
删	刪
创	創
刚	剛
则	則
刘	劉
划	劃
刍	芻
凿	鑿
击	擊
出	出
凶	兇
凯	凱
凭	憑
凫	鳧
凤	鳳
几	幾
凛	凜
凑	湊
减	減
凌	凌
凉	涼
准	準
凄	悽
净	淨
冻	凍
况	況
决	決
冲	衝
冯	馮
冬	冬
农	農
军	軍
写	寫
册	冊
冈	岡
内	內
冁	囅
兽	獸
养	養
兹	茲
兴	興
关	關
兰	蘭
党	黨
兖	兗
兑	兌
克	克
儿	兒
僵	僵
傩	儺
储	儲
傧	儐
傥	儻
傤	儎
偿	償
偾	僨
偻	僂
偬	傯
倾	傾
债	債
借	借
修	修
俭	儉
俫	倈
俪	儷
俩	倆
俨	儼
俦	儔
俣	俁
俊	俊
侭	儘
侬	儂
侪	儕
侩	儈
侨	僑
侧	側
侦	偵
侥	僥
侣	侶
侠	俠
佥	僉
佣	傭
佛	佛
余	餘
体	體
伫	佇
伪	僞
伧	傖
伦	倫
伥	倀
伤	傷
伣	俔
伡	俥
传	傳
伟	偉
伞	傘
伛	傴
会	會
伙	夥
优	優
众	衆
仿	仿
价	價
们	們
仪	儀
仓	倉
仑	侖
从	從
仇	仇
仆	僕
仅	僅
亿	億
亸	嚲
亵	褻
亲	親
亩	畝
产	產
亚	亞
亘	亙
云	雲
亏	虧
于	於
争	爭
了	了
乱	亂
买	買
书	書
乡	鄉
习	習
乔	喬
乐	樂
乌	烏
义	義
么	麼
举	舉
丽	麗
为	爲
临	臨
丰	豐
个	個
丧	喪
严	嚴
两	兩
丢	丟
丝	絲
东	東
丛	叢
业	業
专	專
丑	醜
与	與
万	萬
䶮	龑
䴙	鸊
䴘	鷉
䴗	鶪
䴖	鶄
䴕	鴷
䴔	鵁
䴓	鳾
䲣	䱷
䲢	鰧
䲡	鰌
䲠	鰆
䲟	鮣
䲞	𩶘
䲝	䱽
䯅	䯀
䯄	騧
䯃	𩣑
䭪	𩞯
䩄	靦
䦷	䦟
䦶	䦛
䦆	钁
䦅	鐥
䦃	鐯
䦂	䥇
䦁	𨧜
䦀	𨦫
䥿	𨯅
䥾	䥱
䥽	鏺
䥺	釾
䢂	𨋢
䢁	𨊸
䢀	𨊰
䟢	躎
䞐	賰
䞎	𧶧
䞍	䝼
䞌	𧵳
䝙	貙
䜩	讌
䜧	䜀
䜥	𧩙
䜤	鿁
䜣	訢
䙓	襬
䙌	䙡
䙊	𧜵
䘞	𧜗
䘛	𧝞
䗖	螮
䓨	罃
䓖	藭
䓕	薳
䓓	薵
䑽	𦪙
䏝	膞
䎬	䎱
䍠	䍦
䍁	繸
䍀	繿
䌿	䋹
䌾	䋻
䌽	綵
䌼	綐
䌻	䋚
䌺	䋙
䌹	絅
䌸	縳
䌷	紬
䌶	䊷
䉤	籔
䇲	筴
䅪	𥢢
䅟	穇
䅉	稏
䃅	磾
䂵	碽
䁖	瞜
䀥	䁻
㻘	𤪺
㻏	𤫩
㻅	璯
㺍	獱
㶽	煱
㶶	燶
㶉	鸂
㴋	潚
㳽	瀰
㳢	𣾷
㳡	濄
㳠	澾
㳕	灡
㳔	濧
㲿	瀇
㱮	殨
㱩	殰
㭴	樫
㭤	樢
㭣	𣙎
㭏	椲
㭎	棡
㨫	㩜
㧰	擽
㧟	擓
㧑	撝
㧐	㩳
㧏	掆
㥪	慺
㤽	懤
㤘	㥮
㡎	幓
㟥	嵾
㟜	𡾱
㟆	㠏
㛿	𡠹
㛤	孋
㛣	㜏
㛠	𡢃
㛟	𡞵
㛀	媰
㚯	㜄
㘎	㘚
㖞	喎
㖊	噚
㔉	劚
㓰	劃
㓥	劏
㓆	𠗣
㑩	儸
㑔	㑯
㑈	倲
㑇	㑳
㐽	偑
㐹	㑶
㐷	傌
